#####################
#....@....#.........#
#.........#.........#
#####..####.........#
#...................#
#...................#
#...................#
#...........&.......#
#...................#
#####################